+-+-+-+-+-+
|     |   |
+-+-+ +-+ +
|   | | | |
+-+ + + + +
|       | |
+ +-+ +-+ +
|   |   | |
+-+ +-+-+ +
|     | | |
+ +-+ + + +
|   |     |
+-+-+-+-+-+
